8 7
1 2 7 5
11111111
00000111
10110011
10111001
10111101
10000001
11111111
